#define 20 width
#define 20 height
#define Map_1 name

 5  5  5  5  5  5  5  5  5  5  5  5  5  5  5  5  5  5  5  5
 5  1  1  1  1  1  1  1  1  1  1  1  1  1 10 11 12 13 14  5
 5  1  1  1  1  1  1  1  1  1  1  1  1  1 15 16 17 18 19  5
 5  5  1  5  1  5  1  5  1  5  1  1  1  1 20 21 22 23 24  5
 5  1  5  1  5  1  5  1  5  1  5  1  1  1 25 26 27 28 29  5
 5  1  1  1  1  1  1  1  1  1  1  1  1  1 30 31 32 33 34  5
 5  1  1  1  1  1  1  1  1  1  1  1  1  1 35 36 37 38 39  5
 1  1  1  1  1  1  1  1  1  1  1  1  1  1  1  1  1  1  1  1
 1  1  1  1  1  1  1  1  1  5  1  1  1  1  1  1  1  1  1  1
 1  1  1  1  1  1  1  1  1  1  1  1  1  1  1  1  1  1  1  1
 5  1  1  1  1  1  1  1  1  1  1  1  1  1  1  1  1  1  1  5
 5  1  1  1  1  1  1  1  1  1  1  1  1  1  1  1  1  1  1  5
 5  1  1  1  1  1  1  1  1  1  4  4  1  4  1  1  1  1  1  5
 5  1  1  1  1  1  1  1  1  1  4  4  1  1  1  1  1  1  1  5
 5  1  1  1 50 51  1  1 50 51  1  1 50 51  1  1  1  1  1  5
 5  1  1  1 52 53  1  1 52 53  1  1 52 53  1  1  1  1  1  5
 5  1  3  1  1  1  1  1  1  1  1  1  1  1  1  3  3  3  3  5
 5  1  3  1  1  1  1  1  1  1  1  1  1  1  1  1  3  5  1  5
 5  1  3  3  1  1  1  1  1  1  1  1  1  1  1  3  3  3  3  5
 5  5  5  5  5  5  5  5  5  5  5  5  5  5  5  5  5  5  5  5

 2  2  2  2  2  2  2  2  2  2  2  2  2  2  2  2  2  2  2  2
 2  2  2  2  2  2  2  2  2  2  2  2  2  2  2  2  2  2  2  2
 2  2  2  2  2  2  2  2  2  2  2  2  2  2  2  2  2  2  2  2
 2  2  2  2  2  2  2  2  2  2  2  2  2  2  2  2  2  2  2  2
 2  2  2  2  2  2  2  2  2  2  2  2  2  2  2  2  2  2  2  2
 2  2  2  2  2  2  2  2  2  2  2  2  2  2  2  2  2  2  2  2
 2  2  2  2  2  2  2  2  2  2  2  2  2  2  2  2  2  2  2  2
 2  2  2  2  2  2  2  2  2  2  2  2  2  2  2  2  2  2  2  2
 2  2  2  2  2  2  2  2  2  2  2  2  2  2  2  2  2  2  2  2
 2  2  2  2  2  2  2  2  2  2  2  2  2  2  2  2  2  2  2  2
 2  2  2  2  2  2  2  2  2  2  2  2  2  2  2  2  2  2  2  2
 2  2  2  2  2  2  2  2  2  2  2  2  2  2  2  2  2  2  2  2
 2  2  2  2  2  2  2  2  2  2  2  2  2  2  2  2  2  2  2  2
 2  2  2  2  2  2  2  2  2  2  2  2  2  2  2  2  2  2  2  2
 2  2  2  2  2  2  2  2  2  2  2  2  2  2  2  2  2  2  2  2
 2  2  2  2  2  2  2  2  2  2  2  2  2  2  2  2  2  2  2  2
 2  2  2  2  2  2  2  2  2  2  2  2  2  2  2  2  2  2  2  2
 2  2  2  2  2  2  2  2  2  2  2  2  2  2  2  2  2  2  2  2
 2  2  2  2  2  2  2  2  2  2  2  2  2  2  2  2  2  2  2  2
 2  2  2  2  2  2  2  2  2  2  2  2  2  2  2  2  2  2  2  2

0 ./img/tileset_misc.xpm 48 16
1 ./img/tileset_base.xpm 32 32
2 ./img/pokecenter.xpm 80 96
3 ./img/tileset_fountain.xpm 192 32
------------------------------------------------------------
0 0 0 0 1 0 0 0
1 0 1 0 0 0 0 0
2 1 0 0 0 0 0 0
3 1 0 1 0 0 0 0
4 1 1 1 1 0 0 0
5 1 1 0 1 0 0 0
10 2 0 0 0 0 1 0
11 2 1 0 0 0 1 0
12 2 2 0 0 0 1 0
13 2 3 0 0 0 1 0
14 2 4 0 0 0 1 0
15 2 0 1 0 0 1 0
16 2 1 1 0 0 1 0
17 2 2 1 0 0 1 0
18 2 3 1 0 0 1 0
19 2 4 1 0 0 1 0
20 2 0 2 1 0 0 0
21 2 1 2 1 0 0 0
22 2 2 2 1 0 0 0
23 2 3 2 1 0 0 0
24 2 4 2 1 0 0 0
25 2 0 3 1 0 0 0
26 2 1 3 1 0 0 0
27 2 2 3 1 0 0 0
28 2 3 3 1 0 0 0
29 2 4 3 1 0 0 0
30 2 0 4 1 0 0 0
31 2 1 4 1 0 0 0
32 2 2 4 1 0 0 0
33 2 3 4 1 0 0 0
34 2 4 4 1 0 0 0
35 2 0 5 1 0 0 0
36 2 1 5 1 0 0 0
37 2 2 5 0 0 0 1 ./map/pokecenter.map 7 8 1 1
38 2 3 5 1 0 0 0
39 2 4 5 1 0 0 0
50 3 0 0 1 0 1 0
51 3 1 0 1 0 1 0
52 3 0 1 1 0 0 0
53 3 1 1 1 0 0 0
------------------------------------------------------------
250 50 3 2 0
250 51 3 3 0
250 52 3 2 1
250 53 3 3 1
500 50 3 4 0
500 51 3 5 0
500 52 3 4 1
500 53 3 5 1
750 50 3 6 0
750 51 3 7 0
750 52 3 6 1
750 53 3 7 1
1000 50 3 8 0
1000 51 3 9 0
1000 52 3 8 1
1000 53 3 9 1
1250 50 3 10 0
1250 51 3 11 0
1250 52 3 10 1
1250 53 3 11 1
1500 50 3 0 0
1500 51 3 1 0
1500 52 3 0 1
1500 53 3 1 1
1750 50 3 2 0
1750 51 3 3 0
1750 52 3 2 1
1750 53 3 3 1
2000 50 3 4 0
2000 51 3 5 0
2000 52 3 4 1
2000 53 3 5 1
2250 50 3 6 0
2250 51 3 7 0
2250 52 3 6 1
2250 53 3 7 1
2500 50 3 8 0
2500 51 3 9 0
2500 52 3 8 1
2500 53 3 9 1
2750 50 3 10 0
2750 51 3 11 0
2750 52 3 10 1
2750 53 3 11 1
3000 50 3 0 0
3000 51 3 1 0
3000 52 3 0 1
3000 53 3 1 1
