#define 20 width
#define 20 height
#define Map_1 name

 5  5  5  5  5  5  5  5  5  5  5  5  5  5  5  5  5  5  5  5
 5  1  1  1  1  1  1  1  1  1  1  1  1  1 10 11 12 13 14  5
 5  1  1  1  1  1  1  1  1  1  1  1  1  1 15 16 17 18 19  5
 5  5  1  5  1  5  1  5  1  5  1  5  1  1 20 21 22 23 24  5
 5  1  5  1  5  1  5  1  5  1  5  1  1  1 25 26 27 28 29  5
 5  1  1  1  1  1  1  1  1  1  1  1  1  1 30 31 32 33 34  5
 5  1  1  1  1  1  1  1  1  1  1  1  1  1 35 36 37 38 39  5
 5  1  1  1  1  1  1  1  1  1  1  1  1  1  1  1  1  1  1  5
 5  1  1  1  1  1  1  1  1  5  1  1  1  1  1  1  1  1  1  5
 5  1  1  1  1  1  1  1  1  1  1  1  1  1  1  1  1  1  1  5
 5  1  1  1  1  1  1  1  1  1  1  1  1  1  1  1  1  1  1  5
 5  1  1  1  1  1  1  1  1  1  1  1  1  1  1  1  1  1  1  5
 5  1  1  1  1  1  1  1  1  1  4  4  1  4  1  1  1  1  1  5
 5  1  1  1  1  1  1  1  1  1  4  4  1  1  1  1  1  1  1  5
 5  1  1  1  1  1  1  1  1  1  1  5  1  1  1  1  1  1  1  5
 5  1  1  1  1  1  1  1  1  1  1  1  1  1  1  1  1  1  1  5
 5  1  3  1  1  1  1  1  1  1  1  1  1  1  1  3  3  3  3  5
 5  1  3  1  1  1  1  1  1  1  1  1  1  1  1  1  3  5  1  5
 5  1  3  3  1  1  1  1  1  1  1  1  1  1  1  3  3  3  3  5
 5  5  5  5  5  5  5  5  5  5  5  5  5  5  5  5  5  5  5  5

 2  2  2  2  2  2  2  2  2  2  2  2  2  2  2  2  2  2  2  2
 2  2  2  2  2  2  2  2  2  2  2  2  2  2  2  2  2  2  2  2
 2  2  2  2  2  2  2  2  2  2  2  2  2  2  2  2  2  2  2  2
 2  2  2  2  2  2  2  2  2  2  2  2  2  2  2  2  2  2  2  2
 2  2  2  2  2  2  2  2  2  2  2  2  2  2  2  2  2  2  2  2
 2  2  2  2  2  2  2  2  2  2  2  2  2  2  2  2  2  2  2  2
 2  2  2  2  2  2  2  2  2  2  2  2  2  2  2  2  2  2  2  2
 2  2  2  2  2  2  2  2  2  2  2  2  2  2  2  2  2  2  2  2
 2  2  2  2  2  2  2  2  2  2  2  2  2  2  2  2  2  2  2  2
 2  2  2  2  2  2  2  2  2  2  2  2  2  2  2  2  2  2  2  2
 2  2  2  2  2  2  2  2  2  2  2  2  2  2  2  2  2  2  2  2
 2  2  2  2  2  2  2  2  2  2  2  2  2  2  2  2  2  2  2  2
 2  2  2  2  2  2  2  2  2  2  2  2  2  2  2  2  2  2  2  2
 2  2  2  2  2  2  2  2  2  2  2  2  2  2  2  2  2  2  2  2
 2  2  2  2  2  2  2  2  2  2  2  2  2  2  2  2  2  2  2  2
 2  2  2  2  2  2  2  2  2  2  2  2  2  2  2  2  2  2  2  2
 2  2  2  2  2  2  2  2  2  2  2  2  2  2  2  2  2  2  2  2
 2  2  2  2  2  2  2  2  2  2  2  2  2  2  2  2  2  2  2  2
 2  2  2  2  2  2  2  2  2  2  2  2  2  2  2  2  2  2  2  2
 2  2  2  2  2  2  2  2  2  2  2  2  2  2  2  2  2  2  2  2

0 ./img/tileset_misc.xpm 32 16
1 ./img/tileset_base.xpm 32 32
2 ./img/pokecenter.xpm 80 96
------------------------------------------------------------
0 0 0 0 1 0 0
1 0 1 0 0 0 0
2 1 0 0 0 0 0
3 1 0 1 0 0 0
4 1 1 1 1 0 0
5 1 1 0 1 0 0
10 2 0 0 0 0 0
11 2 1 0 0 0 0
12 2 2 0 0 0 0
13 2 3 0 0 0 0
14 2 4 0 0 0 0
15 2 0 1 1 0 0
16 2 1 1 1 0 0
17 2 2 1 1 0 0
18 2 3 1 1 0 0
19 2 4 1 1 0 0
20 2 0 2 1 0 0
21 2 1 2 1 0 0
22 2 2 2 1 0 0
23 2 3 2 1 0 0
24 2 4 2 1 0 0
25 2 0 3 1 0 0
26 2 1 3 1 0 0
27 2 2 3 1 0 0
28 2 3 3 1 0 0
29 2 4 3 1 0 0
30 2 0 4 1 0 0
31 2 1 4 1 0 0
32 2 2 4 1 0 0
33 2 3 4 1 0 0
34 2 4 4 1 0 0
35 2 0 5 1 0 0
36 2 1 5 1 0 0
37 2 2 5 0 0 1 ./map/map_2.map 16 7 3 4
38 2 3 5 1 0 0
39 2 4 5 1 0 0
