#define 20 width
#define 20 height
#define Map_1 name

 5  5  5  5  5  5  5  5  5  5  5  5  5  5  5  5  5  5  5  5
 5  1  1  1  1  1  1  1  1 10 11 12 13 14  1  1  1  1  1  5
 5  1  1  1  1  1  1  1  1 15 16 17 18 19  1  1  1  1  1  5
 5  5  1  1  5  1  5  1  5 20 21 22 23 24  1  1  1  1  1  5
 5  1  5  1  5  1  5  1  1 25 26 27 28 29  1  1  1  1  1  5
 5  1  1  1  1  1  1  1  1 30 31 32 33 34  1  1  1  1  1  5
 5  1  1  1  1  1  1  1  1  1  1  1  1  1  1  1  1  1  1  5
 5  1  1  1  1  1  1  1  1  1  1  1  1  1  1  1  1  1  1  5
 5  1  1  1  1  1  1  1  1  5  1  1  1  1  1  1  1  1  1  5
 5  1  1  1  1  1  1  1  1  1  1  1  1  1  1  1  1  1  1  5
 5  1  1  1  1  1  1  1  1  1  1  1  1  1  1  1  1  1  1  5
 5  1  1  1  1  1  1  1  1  1  1  1  1  1  1  1  1  1  1  5
 5  1  1  1  1  1  1  1  1  1  4  4  1  4  1  1  1  1  1  5
 5  1  1  1  1  1  1  1  1  1  4  4  1  1  1  1  1  1  1  5
 5  1  1  1  1  1  1  1  1  1  1  5  1  1  1  1  1  1  1  5
 5  1  1  1  1  1  1  1  1  1  1  1  1  1  1  1  1  1  1  5
 5  1  3  1  1  1  1  1  1  1  1  1  1  1  1  3  3  3  3  5
 5  1  3  1  1  1  1  1  1  1  1  1  1  1  1  1  3  5  1  5
 5  1  3  3  1  1  1  1  1  1  1  1  1  1  1  3  3  3  3  5
 5  5  5  5  5  5  5  5  5  5  5  5  5  5  5  5  5  5  5  5

 2  2  2  2  2  2  2  2  2  2  2  2  2  2  2  2  2  2  2  2
 2  2  2  2  2  2  2  2  2  2  2  2  2  2  2  2  2  2  2  2
 2  2  2  2  2  2  2  2  2  2  2  2  2  2  2  2  2  2  2  2
 2  2  2  2  2  2  2  2  2  2  2  2  2  2  2  2  2  2  2  2
 2  2  2  2  2  2  2  2  2  2  2  2  2  2  2  2  2  2  2  2
 2  2  2  2  2  2  2  2  2  2  2  2  2  2  2  2  2  2  2  2
 2  2  2  2  2  2  2  2  2  2  2  2  2  2  2  2  2  2  2  2
 2  2  2  2  2  2  2  2  2  2  2  2  2  2  2  2  2  2  2  2
 2  2  2  2  2  2  2  2  2  2  2  2  2  2  2  2  2  2  2  2
 2  2  2  2  2  2  2  2  2  2  2  2  2  2  2  2  2  2  2  2
 2  2  2  2  2  2  2  2  2  2  2  2  2  2  2  2  2  2  2  2
 2  2  2  2  2  2  2  2  2  2  2  2  2  2  2  2  2  2  2  2
 2  2  2  2  2  2  2  2  2  2  2  2  2  2  2  2  2  2  2  2
 2  2  2  2  2  2  2  2  2  2  2  2  2  2  2  2  2  2  2  2
 2  2  2  2  2  2  2  2  2  2  2  2  2  2  2  2  2  2  2  2
 2  2  2  2  2  2  2  2  2  2  2  2  2  2  2  2  2  2  2  2
 2  2  2  2  2  2  2  2  2  2  2  2  2  2  2  2  2  2  2  2
 2  2  2  2  2  2  2  2  2  2  2  2  2  2  2  2  2  2  2  2
 2  2  2  2  2  2  2  2  2  2  2  2  2  2  2  2  2  2  2  2
 2  2  2  2  2  2  2  2  2  2  2  2  2  2  2  2  2  2  2  2

0 ./img/misc/black.xpm 1 0 0
1 ./img/misc/transpa.xpm 0 0 0
3 ./img/grass_1.xpm 0 0 0
2 ./img/plant_1.xpm 0 0 0
4 ./img/half_tree_1.xpm 1 0 0 
5 ./img/rock_1.xpm 1 0 0 
10 ./img/pokecenter_1/poke_1.xpm 1 0 0
11 ./img/pokecenter_1/poke_2.xpm 1 0 0
12 ./img/pokecenter_1/poke_3.xpm 1 0 0
13 ./img/pokecenter_1/poke_4.xpm 1 0 0
14 ./img/pokecenter_1/poke_5.xpm 1 0 0
15 ./img/pokecenter_1/poke_6.xpm 1 0 0
16 ./img/pokecenter_1/poke_7.xpm 1 0 0
17 ./img/pokecenter_1/poke_8.xpm 1 0 0
18 ./img/pokecenter_1/poke_9.xpm 1 0 0
19 ./img/pokecenter_1/poke_10.xpm 1 0 0
20 ./img/pokecenter_1/poke_11.xpm 1 0 0
21 ./img/pokecenter_1/poke_12.xpm 1 0 0
22 ./img/pokecenter_1/poke_13.xpm 1 0 0
23 ./img/pokecenter_1/poke_14.xpm 1 0 0
24 ./img/pokecenter_1/poke_15.xpm 1 0 0
25 ./img/pokecenter_1/poke_16.xpm 1 0 0
26 ./img/pokecenter_1/poke_17.xpm 1 0 0
27 ./img/pokecenter_1/poke_18.xpm 1 0 0
28 ./img/pokecenter_1/poke_19.xpm 1 0 0
29 ./img/pokecenter_1/poke_20.xpm 1 0 0
30 ./img/pokecenter_1/poke_21.xpm 1 0 0
31 ./img/pokecenter_1/poke_22.xpm 1 0 0
32 ./img/pokecenter_1/poke_23.xpm 0 0 1 ./map/map_1.map 16 6 3 2
33 ./img/pokecenter_1/poke_24.xpm 1 0 0
34 ./img/pokecenter_1/poke_25.xpm 1 0 0
