#define 20 width
#define 20 height
#define Map_1 name

1 1 1 1 1 1 1 1 1 1 1 1 1 1 1 1 1 1 1 1
1 2 2 2 2 2 2 2 2 2 2 2 2 2 2 2 2 2 2 1
1 2 2 2 2 2 2 2 2 2 2 2 2 2 2 2 2 2 2 1
1 1 2 1 2 1 2 1 2 1 2 1 2 1 2 1 2 1 2 1
1 2 1 2 1 2 1 2 1 2 1 2 1 2 1 2 1 2 1 1
1 2 2 2 2 2 2 2 2 2 2 2 2 2 2 2 2 2 2 1
1 2 2 2 2 2 2 2 2 2 2 2 2 2 2 2 2 2 2 1
1 2 2 2 2 2 2 2 2 2 2 2 2 2 2 2 2 2 2 1
1 2 2 2 2 2 2 2 2 1 2 2 2 2 2 2 2 2 2 1
1 2 2 2 2 2 2 2 2 2 2 2 2 2 2 2 2 2 2 1
1 2 2 2 2 2 2 2 2 2 2 2 2 2 2 2 2 2 2 1
1 2 2 2 2 2 2 2 2 2 2 2 2 2 2 2 2 2 2 1
1 2 2 2 2 2 2 2 2 2 4 4 2 4 2 2 2 2 2 1
1 2 2 2 2 2 2 2 2 2 4 4 2 2 2 2 2 2 2 1
1 2 2 2 2 2 2 2 2 2 2 1 2 2 2 2 2 2 2 1
1 2 2 2 2 2 2 2 2 2 2 2 2 2 2 2 2 2 2 1
1 2 3 2 2 2 2 2 2 2 2 2 2 2 2 3 3 3 3 1
1 2 3 2 2 2 2 2 2 2 2 2 2 2 2 2 3 1 2 1
1 2 3 3 2 2 2 2 2 2 2 2 2 2 2 3 3 3 3 1
1 1 1 1 1 1 1 1 1 1 1 1 1 1 1 1 1 1 1 1

1 ./img/rock_1.xpm 1 0
2 ./img/grass_1.xpm 0 0
3 ./img/plant_1.xpm 0 0
4 ./img/half_tree_1.xpm 1 0
