#define 20 width
#define 20 height
#define Map_1 name

 5  5  5  5  5  5  5  5  5  5  5  5  5  5  5  5  5  5  5  5
 1  1  1  1  1  1  1  1  1  1  1  1  1  1  1  1  1  1  1  1
 1  1  1  1  1  1  1  1  1  1  1  1  1  1  1  1  1  1  1  1
 1  1  1  1  1  1  1  1  1  1  1  1  1  1  1  1  1  1  1  1
 1  1  1  1  1  1  1  1  1  1  1  1  1  1  1  1  1  1  1  1
 1  1  1  1  1  1  1  1  1  1  1  1  1  1  1  1  1  1  1  1
 1 70 71 71 72  1  1  1  1  1  1  1  1  1  1  1  1  1  1  1
 1 73 74 74 75  1  1  1  1  1  1  1  1  1  1  1  1  1  1  1
 1 73 74 74 75  1  1  1  1  1  1  1  1  1  1  1  1  1  1  1
 1 73 74 74 75  1 68 67 67 67 67 67 67 66  1  1  1  1  1  1
 1 73 74 74 75  1 61 10 11 12 13 14 15 65  1  1  1  1  1  1
 1 73 74 74 75  1 61 16 17 18 19 20 21 65  1  1  1  1  1  1
 1 73 74 74 75  1 61 22 23 24 25 26 27 65  1  1  1  1  1  1
 1 73 74 74 75  1 61 28 29 30 31 32 33 65  1  1  1  1  1  1
 1 73 74 74 75  1 61 34 35 36 37 38 39 65  1  1  1  1  1  1
 1 73 74 74 75  1 61 40 41 42 43 44 45 65  1  1  1  1  1  1
 1 76 77 77 78  1 62 60 46 47 48 49 60 64  1  3  3  3  3  1
 1  1  1  1  1  1  1 62 63 63 63 63 64  1  1  1  3  1  1  1
 1  1  1  1  1  1  1  1  1  1  1  1  1  1  1  3  3  3  3  1
 1  1  1  1  1  1  1  1  1  1  1  1  1  1  1  1  1  1  1  1

 2  2  2  2  2  2  2  2  2  2  2  2  2  2  2  2  2  2  2  2
 2  2  2  2  2  2  2  2  2  2  2  2  2  2  2  2  2  2  2  2
 2  2  2  2  2  2  2  2  2  2  2  2  2  2  2  2  2  2  2  2
 2  2  2  2  2  2  2  2  2  2  2  2  2  2  2  2  2  2  2  2
 2  2  2  2  2  2  2  2  2  2  2  2  2  2  2  2  2  2  2  2
 2  2  2  2  2  2  2  2  2  2  2  2  2  2  2  2  2  2  2  2
 2  2  2  2  2  2  2  2  2  2  2  2  2  2  2  2  2  2  2  2
 2  2  2  2  2  2  2  2  2  2  2  2  2  2  2  2  2  2  2  2
 2  2  2  2  2  2  2  2  2  2  2  2  2  2  2  2  2  2  2  2
 2  2  2  2  2  2  2  2  2  2  2  2  2  2  2  2  2  2  2  2
 2  2  2  2  2  2  2 60 60 60 60 60 60  2  2  2  2  2  2  2
 2  2  2  2  2  2  2 60  2  2  2  2 60  2  2  2  2  2  2  2
 2  2  2  2  2  2  2 60  2  2  2  2 60  2  2  2  2  2  2  2
 2  2  2  2  2  2  2 60  2  2  2  2 60  2  2  2  2  2  2  2
 2  2  2  2  2  2  2 60  2  2  2  2 60  2  2  2  2  2  2  2
 2  2  2  2  2  2  2 60 60  2  2 60 60  2  2  2  2  2  2  2
 2  2  2  2  2  2  2 60 60 60 60 60 60  2  2  2  2  2  2  2
 2  2  2  2  2  2  2  2  2  2  2  2  2  2  2  2  2  2  2  2
 2  2  2  2  2  2  2  2  2  2  2  2  2  2  2  2  2  2  2  2
 2  2  2  2  2  2  2  2  2  2  2  2  2  2  2  2  2  2  2  2

0 ./img/tileset_misc.xpm 48 16
1 ./img/tileset_base.xpm 32 32
2 ./img/arena.xpm 112 112
3 ./img/tileset_dirt_water.xpm 192 48
------------------------------------------------------------
0 0 0 0 1 0 0 0
1 0 1 0 0 0 0 0
2 1 0 0 0 0 0 0
3 1 0 1 0 0 0 0
4 1 1 1 1 0 0 0
5 1 1 0 1 0 0 0
60 2 6 2 0 0 0 0
61 2 6 1 0 0 0 0
62 2 6 4 0 0 0 0
63 2 6 5 0 0 0 0
64 2 6 6 0 0 0 0
65 2 6 3 0 0 0 0
66 2 6 0 0 0 0 0
67 2 5 6 0 0 0 0
68 2 0 6 0 0 0 0
10 2 0 0 0 0 1 0
11 2 1 0 0 0 1 0
12 2 2 0 0 0 1 0
13 2 3 0 0 0 1 0
14 2 4 0 0 0 1 0
15 2 5 0 0 0 1 0
16 2 0 1 0 0 1 0
17 2 1 1 1 0 0 0
18 2 2 1 1 0 0 0
19 2 3 1 1 0 0 0
20 2 4 1 1 0 0 0
21 2 5 1 0 0 1 0
22 2 0 2 1 0 0 0
23 2 1 2 1 0 0 0
24 2 2 2 1 0 0 0
25 2 3 2 1 0 0 0
26 2 4 2 1 0 0 0
27 2 5 2 1 0 0 0
28 2 0 3 1 0 0 0
29 2 1 3 1 0 0 0
30 2 2 3 1 0 0 0
31 2 3 3 1 0 0 0
32 2 4 3 1 0 0 0
33 2 5 3 1 0 0 0
34 2 0 4 1 0 0 0
35 2 1 4 1 0 0 0
36 2 2 4 1 0 0 0
37 2 3 4 1 0 0 0
38 2 4 4 1 0 0 0
39 2 5 4 1 0 0 0
40 2 0 5 1 0 0 0
41 2 1 5 1 0 0 0
42 2 2 5 1 0 0 0
43 2 3 5 1 0 0 0
44 2 4 5 1 0 0 0
45 2 5 5 1 0 0 0
46 2 1 6 0 0 0 0
47 2 2 6 0 1 0 1 ./map/map_1.map 16 7 3 2
48 2 3 6 0 1 0 1 ./map/map_1.map 16 7 3 3
49 2 4 6 0 0 0 0
70 3 0 0 1 0 0 0
71 3 1 0 1 0 0 0
72 3 2 0 1 0 0 0
73 3 0 1 1 0 0 0
74 3 1 1 1 0 0 0
75 3 2 1 1 0 0 0
76 3 0 2 1 0 0 0
77 3 1 2 1 0 0 0
78 3 2 2 1 0 0 0
------------------------------------------------------------
250 70 3 3 0
250 71 3 4 0
250 72 3 5 0
250 73 3 3 1
250 74 3 4 1
250 75 3 5 1
250 76 3 3 2
250 77 3 4 2
250 78 3 5 2
500 70 3 6 0
500 71 3 7 0
500 72 3 8 0
500 73 3 6 1
500 74 3 7 1
500 75 3 8 1
500 76 3 6 2
500 77 3 7 2
500 78 3 8 2
750 70 3 9 0
750 71 3 10 0
750 72 3 11 0
750 73 3 9 1
750 74 3 10 1
750 75 3 11 1
750 76 3 9 2
750 77 3 10 2
750 78 3 11 2
1000 70 3 0 0
1000 71 3 1 0
1000 72 3 2 0
1000 73 3 0 1
1000 74 3 1 1
1000 75 3 2 1
1000 76 3 0 2
1000 77 3 1 2
1000 78 3 2 2
2250 70 3 3 0
2250 71 3 4 0
2250 72 3 5 0
2250 73 3 3 1
2250 74 3 4 1
2250 75 3 5 1
2250 76 3 3 2
2250 77 3 4 2
2250 78 3 5 2
2500 70 3 6 0
2500 71 3 7 0
2500 72 3 8 0
2500 73 3 6 1
2500 74 3 7 1
2500 75 3 8 1
2500 76 3 6 2
2500 77 3 7 2
2500 78 3 8 2
2750 70 3 9 0
2750 71 3 10 0
2750 72 3 11 0
2750 73 3 9 1
2750 74 3 10 1
2750 75 3 11 1
2750 76 3 9 2
2750 77 3 10 2
2750 78 3 11 2
3000 70 3 0 0
3000 71 3 1 0
3000 72 3 2 0
3000 73 3 0 1
3000 74 3 1 1
3000 75 3 2 1
3000 76 3 0 2
3000 77 3 1 2
3000 78 3 2 2
