#define 20 width
#define 20 height
#define Map_1 name

 5  5  5  5  5  5  5  5  5  5  5  5  5  5  5  5  5  5  5  5
 1  1  1  1  1  1  1  1  1  1  1  1  1  1  1  1  1  1  1  1
 1  1  1  1  1  1  1  1  1  1  1  1  1  1  1  1  1  1  1  1
 1  1  1  1  1  1  1  1  1  1  1  1  1  1  1  1  1  1  1  1
 1  1  1  1  1  1  1  1  1  1  1  1  1  1  1  1  1  1  1  1
 1  1  1  1  1  1  1  1  1  1  1  1  1  1  1  1  1  1  1  1
 1  1  1  1  1  1  1  1  1  1  1  1  1  1  1  1  1  1  1  1
 1  1  1  1  1  1  1  1  1  1  1  1  1  1  1  1  1  1  1  1
 1  1  1  1  1  1  1  1  1  1  1  1  1  1  1  1  1  1  1  1
 1  1  1  1  1  1 68 67 67 67 67 67 67 66  1  1  1  1  1  1
 1  1  1  1  1  1 61 10 11 12 13 14 15 65  1  1  1  1  1  1
 1  1  1  1  1  1 61 16 17 18 19 20 21 65  1  1  1  1  1  1
 1  1  1  1  1  1 61 22 23 24 25 26 27 65  1  1  1  1  1  1
 1  1  1  1  1  1 61 28 29 30 31 32 33 65  1  1  1  1  1  1
 1  1  1  1  1  1 61 34 35 36 37 38 39 65  1  1  1  1  1  1
 1  1  1  1  1  1 61 40 41 42 43 44 45 65  1  1  1  1  1  1
 1  1  3  1  1  1 62 60 46 47 48 49 60 64  1  3  3  3  3  1
 1  1  3  1  1  1  1 62 63 63 63 63 64  1  1  1  3  1  1  1
 1  1  3  3  1  1  1  1  1  1  1  1  1  1  1  3  3  3  3  1
 1  1  1  1  1  1  1  1  1  1  1  1  1  1  1  1  1  1  1  1

 2  2  2  2  2  2  2  2  2  2  2  2  2  2  2  2  2  2  2  2
 2  2  2  2  2  2  2  2  2  2  2  2  2  2  2  2  2  2  2  2
 2  2  2  2  2  2  2  2  2  2  2  2  2  2  2  2  2  2  2  2
 2  2  2  2  2  2  2  2  2  2  2  2  2  2  2  2  2  2  2  2
 2  2  2  2  2  2  2  2  2  2  2  2  2  2  2  2  2  2  2  2
 2  2  2  2  2  2  2  2  2  2  2  2  2  2  2  2  2  2  2  2
 2  2  2  2  2  2  2  2  2  2  2  2  2  2  2  2  2  2  2  2
 2  2  2  2  2  2  2  2  2  2  2  2  2  2  2  2  2  2  2  2
 2  2  2  2  2  2  2  2  2  2  2  2  2  2  2  2  2  2  2  2
 2  2  2  2  2  2  2  2  2  2  2  2  2  2  2  2  2  2  2  2
 2  2  2  2  2  2  2 60 60 60 60 60 60  2  2  2  2  2  2  2
 2  2  2  2  2  2  2 60  2  2  2  2 60  2  2  2  2  2  2  2
 2  2  2  2  2  2  2 60  2  2  2  2 60  2  2  2  2  2  2  2
 2  2  2  2  2  2  2 60  2  2  2  2 60  2  2  2  2  2  2  2
 2  2  2  2  2  2  2 60  2  2  2  2 60  2  2  2  2  2  2  2
 2  2  2  2  2  2  2 60 60  2  2 60 60  2  2  2  2  2  2  2
 2  2  2  2  2  2  2 60 60 60 60 60 60  2  2  2  2  2  2  2
 2  2  2  2  2  2  2  2  2  2  2  2  2  2  2  2  2  2  2  2
 2  2  2  2  2  2  2  2  2  2  2  2  2  2  2  2  2  2  2  2
 2  2  2  2  2  2  2  2  2  2  2  2  2  2  2  2  2  2  2  2

0 ./img/tileset_misc.xpm 48 16
1 ./img/tileset_base.xpm 32 32
2 ./img/arena.xpm 112 112
------------------------------------------------------------
0 0 0 0 1 0 0 0
1 0 1 0 0 0 0 0
2 1 0 0 0 0 0 0
3 1 0 1 0 0 0 0
4 1 1 1 1 0 0 0
5 1 1 0 1 0 0 0
60 2 6 2 0 0 0 0
61 2 6 1 0 0 0 0
62 2 6 4 0 0 0 0
63 2 6 5 0 0 0 0
64 2 6 6 0 0 0 0
65 2 6 3 0 0 0 0
66 2 6 0 0 0 0 0
67 2 5 6 0 0 0 0
68 2 0 6 0 0 0 0
10 2 0 0 0 0 1 0
11 2 1 0 0 0 1 0
12 2 2 0 0 0 1 0
13 2 3 0 0 0 1 0
14 2 4 0 0 0 1 0
15 2 5 0 0 0 1 0
16 2 0 1 0 0 1 0
17 2 1 1 1 0 0 0
18 2 2 1 1 0 0 0
19 2 3 1 1 0 0 0
20 2 4 1 1 0 0 0
21 2 5 1 0 0 1 0
22 2 0 2 1 0 0 0
23 2 1 2 1 0 0 0
24 2 2 2 1 0 0 0
25 2 3 2 1 0 0 0
26 2 4 2 1 0 0 0
27 2 5 2 1 0 0 0
28 2 0 3 1 0 0 0
29 2 1 3 1 0 0 0
30 2 2 3 1 0 0 0
31 2 3 3 1 0 0 0
32 2 4 3 1 0 0 0
33 2 5 3 1 0 0 0
34 2 0 4 1 0 0 0
35 2 1 4 1 0 0 0
36 2 2 4 1 0 0 0
37 2 3 4 1 0 0 0
38 2 4 4 1 0 0 0
39 2 5 4 1 0 0 0
40 2 0 5 1 0 0 0
41 2 1 5 1 0 0 0
42 2 2 5 1 0 0 0
43 2 3 5 1 0 0 0
44 2 4 5 1 0 0 0
45 2 5 5 1 0 0 0
46 2 1 6 0 0 0 0
47 2 2 6 0 1 0 1 ./map/map_1.map 16 7 3 2
48 2 3 6 0 1 0 1 ./map/map_1.map 16 7 3 3
49 2 4 6 0 0 0 0
