#define 15 width
#define 10 height
#define Pokecenter name

  10  50   1   1   1   1   1  72  73   1   1  78  81  82  13
  11  51  55  56  89  68  69  74  75  76  65  79  83  84  14
  12  52  57  58  59  66  66  67  66  66  64  80   1   1  15
   1  53  54   1  60  61  61  62  61  61  63   1   1   1   1
   1   1   1   1   1   1   1   1   1   1   1   1   1   1   1
   1   1   1   1   1   1   1   1   1   1   1   1   1   1   1
   1   1   1   1   1   1   1   1   1   1   1  54  85  86   1
   1   1   1   1   1   1   1   1   1   1   1  53  87  88   1
  19   1   1   1   1   1   1  90  91   1   1   1  53  54  21
   0   0   0   0   0   0   0  92  92   0   0   0   0   0   0

   0  16  16  16  16  16  16  16  16  16  16  16  16  16   0
   1  17  17  17  17  17  17  17  17  17  17  17  17  17   1
   1  22  23  23  24  70  71  25  25  77  24  23  26  27   1
  18  24  24  30  24   1   1   1   1   1  24  29  30  30  20
  18  30  30  30  32  31  31  33  34  31  31  28  30  30  20
  18  30  30  30  30  30  35  36  37  38  30  30  30  30  20
  18  30  30  30  30  30  40  41  42  39  30  24  42  42  20
  18  30  30  30  30  30  30  40  39  30  30  24  43  43  20
   0  30  30  30  30  30  30   1   1  30  30  30  24  24   0
   1   1   1   1   1   1   1   1   1   1   1   1   1   1   1

0 ./img/tileset_misc.xpm 32 16
1 ./img/tileset_pokecenter.xpm 192 128
------------------------------------------------------------
0 0 0 0 1 0 0 0
1 0 1 0 0 0 0 0
10 1 1 1 1 0 0 0
11 1 1 2 1 0 0 0
12 1 1 3 1 0 0 0
13 1 2 1 1 0 0 0
14 1 2 2 1 0 0 0
15 1 2 3 1 0 0 0
16 1 3 1 1 0 0 0
17 1 3 2 1 0 0 0
18 1 5 3 0 0 0 0
19 1 6 1 1 0 0 0
20 1 6 3 0 0 0 0
21 1 6 2 1 0 0 0
22 1 5 1 0 0 0 0
23 1 4 3 0 0 0 0
24 1 1 7 0 0 0 0
25 1 4 3 0 0 0 0
26 1 4 1 0 0 0 0
27 1 3 3 0 0 0 0
28 1 7 2 0 0 0 0
29 1 7 1 0 0 0 0
30 1 5 2 0 0 0 0
31 1 7 3 0 0 0 0
32 1 8 1 0 0 0 0
33 1 8 2 0 0 0 0
34 1 8 3 0 0 0 0
35 1 9 1 0 0 0 0
36 1 9 2 0 0 0 0
37 1 9 3 0 0 0 0
38 1 10 1 0 0 0 0
39 1 11 2 0 0 0 0
40 1 10 2 0 0 0 0
41 1 10 3 0 0 0 0
42 1 11 1 0 0 0 0
43 1 4 3 0 0 0 0
50 1 11 4 0 0 0 0
51 1 10 4 0 0 0 0
52 1 9 4 0 0 0 0
53 1 2 4 0 0 0 0
54 1 1 4 0 0 0 0
55 1 1 5 0 0 0 0
56 1 2 5 0 0 0 0
57 1 3 5 0 0 0 0
58 1 4 5 0 0 0 0
59 1 5 7 1 0 0 0
60 1 4 7 1 0 0 0
61 1 10 6 1 0 0 0
62 1 2 7 1 0 0 0
63 1 9 6 1 0 0 0
64 1 8 6 1 0 0 0
65 1 7 6 1 0 0 0
66 1 11 6 0 0 0 0
67 1 3 7 0 0 0 0
68 1 7 7 0 0 0 0
69 1 8 7 0 0 0 0
70 1 9 7 0 0 0 0
71 1 10 7 0 0 0 0
72 1 1 6 0 0 0 0
73 1 2 6 0 0 0 0
74 1 3 6 0 0 0 0
75 1 4 6 0 0 0 0
76 1 5 6 0 0 0 0
77 1 6 6 0 0 0 0
78 1 9 5 0 0 0 0
79 1 10 5 0 0 0 0
80 1 11 5 0 0 0 0
81 1 5 5 0 0 0 0
82 1 6 5 0 0 0 0
83 1 7 5 0 0 0 0
84 1 8 5 0 0 0 0
85 1 3 4 1 0 0 0
86 1 4 4 1 0 0 0
87 1 5 4 1 0 0 0
88 1 6 4 1 0 0 0
89 1 6 7 1 0 0 0
90 1 7 4 0 0 0 0
91 1 8 4 0 0 0 0
92 0 0 0 0 0 0 1 ./map/map_1.map 16 7 3 1
